20 20
P...................
..##................
..##................
....................
....................
..._____...______...
..______...______...
...____.....____....
....................
#...................
....................
....###......##.....
...#####....###.....
....###.....###.....
....................
....................
........________....
......_______.......
......______........
....................
